Date,Trips over the past 24-hours (midnight to 11:59pm),Cumulative trips (since launch):,Miles traveled today (midnight to 11:59 pm),Miles traveled to date:,Total Annual Members,Annual Member Sign-Ups (midnight to 11:59 pm),24-Hour Passes Purchased (midnight to 11:59 pm),7-Day Passes Purchased (midnight to 11:59 pm)
5/27/13,9767,9767,21.533,"21,533",17216,2043,0,0
5/28/13,5215,14982,8.78,"30,313",19816,2598,0,0
5/29/13,10981,25963,21.898,"52,211",21986,2167,0,0
5/30/13,9850,35813,20.321,"72,532",23985,1998,0,0
5/31/13,9253,45066,20.243,"92,775",25615,1630,0,0
6/1/13,9852,54918,26.347,"119,122",26756,1141,0,0
6/2/13,17590,72508,52.143,"171,266",28253,1496,4723,289
6/3/13,8599,81107,18.907,"190,173",29616,1363,1160,221
6/4/13,17589,98696,48.666,"238,839",31095,1479,2922,394
6/5/13,17433,116129,44.917,"283,757",32620,1530,2821,279
6/6/13,13732,129861,30.987,"314,743",33954,1334,1872,210
6/7/13,1393,131254,2.065,"316,809",34449,495,66,11
6/8/13,19899,151153,54.665,"371,473",35233,784,5013,230
6/9/13,23236,174389,71.604,"443,077",36295,1062,5772,275
6/10/13,4504,178893,10.138,"453,215",37086,791,290,82
6/11/13,14638,193531,34.63,"487,845",37894,808,1836,273
6/12/13,18960,212491,45.714,"533,559",38805,911,2767,316
6/13/13,8782,221273,15.075,"548,634",39442,637,701,119
6/14/13,16423,237696,33.98,"582,614",40078,636,2268,211
6/15/13,27276,264972,72.792,"655,406",40702,624,6107,319
6/16/13,23610,288582,59.573,"714,979",41541,839,4413,314
6/17/13,21278,309860,43.897,"758,876",42564,1023,2378,530
6/18/13,14826,324686,27.67,"786,546",43394,830,1236,277
6/19/13,26267,350953,54.405,"840,951",44223,829,2678,607
6/20/13,28994,379947,59.935,"900,886",45024,801,2814,421
6/21/13,30660,410607,64.872,"965,759",45815,791,3465,408
6/22/13,31885,442492,80.433,"1,046,191",46448,633,5902,383
6/23/13,30653,473145,76.45,"1,122,641",47203,755,4959,279
6/24/13,26636,499781,50.664,"1,173,305",48135,932,1844,386
6/25/13,30426,530207,56.075,"1,229,380",48915,780,1937,343
6/26/13,32322,562529,59.663,"1,289,043",49665,750,2000,301
6/27/13,28094,590623,55.26,"1,344,304",50355,690,1680,223
6/28/13,30595,621218,58.037,"1,402,340",51029,674,2268,291
6/29/13,32947,654165,77.226,"1,479,567",51505,476,4895,296
6/30/13,27285,681450,61.052,"1,540,619",52125,620,3592,178
7/1/13,20151,701601,36.168,"1,576,787",52722,597,846,167
7/2/13,26682,728283,48.733,"1,625,520",53310,588,1435,219
7/3/13,25509,753792,46.016,"1,671,537",53748,438,1419,189
7/4/13,26004,779796,63.674,"1,735,210",54073,325,4219,257
7/5/13,25541,805337,53.419,"1,788,629",54507,434,2803,215
7/6/13,23697,829034,53.761,"1,842,391",54843,336,3178,172
7/7/13,23688,852722,50.634,"1,893,025",55284,441,2703,186
7/8/13,26063,878785,49.831,"1,942,856",55971,687,1453,321
7/9/13,30929,909714,55.499,"1,998,355",56610,639,1379,287
7/10/13,30705,940419,55.948,"2,054,304",57194,584,1435,223
7/11/13,29689,970108,56.393,"2,110,697",57725,531,1478,196
7/12/13,22817,992925,39.97,"2,150,667",58133,408,1096,118
7/13/13,30132,1023057,64.833,"2,215,501",58495,362,3285,213
7/14/13,33545,1056602,75.02,"2,290,520",58954,459,3681,224
7/15/13,32565,1089167,57.755,"2,348,275",59593,639,1382,273
7/16/13,34757,1123924,61.856,"2,410,132",60129,536,1288,251
7/17/13,35172,1159096,60.698,"2,470,829",60619,490,1303,201
7/18/13,33222,1192318,56.228,"2,527,057",61008,389,1094,143
7/19/13,30667,1222985,52.784,"2,579,841",61366,358,1389,164
7/20/13,29145,1252130,58.799,"2,638,640",61652,286,2811,169
7/21/13,34694,1286824,76.31,"2,714,950",62074,422,3502,191
7/22/13,29787,1316611,50.145,"2,765,095",62577,503,1005,184
7/23/13,37296,1353907,65.911,"2,831,006",63026,449,1390,220
7/24/13,40699,1394606,74.469,"2,905,475",63466,440,1708,211
7/25/13,36207,1430813,62.188,"2,967,663",63822,356,1163,144
7/26/13,39499,1470312,72.71,"3,040,373",64182,360,2073,176
7/27/13,37131,1507443,82.27,"3,122,643",64495,313,4259,197
7/28/13,26780,1534223,53.562,"3,176,204",64884,389,2391,137
7/29/13,40018,1574241,73.425,"3,249,630",65381,497,1712,275
7/30/13,42982,1617223,77.917,"3,327,547",65855,474,1701,237
7/31/13,42745,1659968,76.982,"3,404,528",66310,455,1692,186
8/1/13,23025,1682993,34.794,"3,439,323",66644,334,415,73
8/2/13,40654,1723647,75.39,"3,514,713",67027,383,2302,230
8/3/13,34173,1757820,73.3,"3,588,013",67293,266,3417,180
8/4/13,40103,1797923,93.191,"3,681,204",67685,392,4547,261
8/5/13,41759,1839682,78.764,"3,759,968",68242,557,1924,276
8/6/13,42974,1882656,79.262,"3,839,230",68744,502,1778,222
8/7/13,39120,1921776,66.709,"3,905,939",69137,393,1261,183
8/8/13,32063,1953839,51.665,"3,957,604",69436,299,946,137
8/9/13,32926,1986765,54.952,"4,012,556",69722,286,1269,134
8/10/13,43368,2030133,103.744,"4,116,300",69996,274,5567,223
8/11/13,37161,2067294,83.004,"4,199,304",70368,372,3826,234
8/12/13,35646,2102940,62.896,"4,262,200",70799,431,1314,257
8/13/13,25569,2128509,44.374,"4,306,574",71121,322,787,111
8/14/13,43437,2171946,78.481,"4,385,055",71481,360,1727,219
8/15/13,42922,2214868,76.299,"4,461,354",71862,381,1733,179
8/16/13,41251,2256119,77.044,"4,538,398",72207,345,2085,170
8/17/13,44284,2300403,104.29,"4,642,688",72471,264,5729,217
8/18/13,31512,2331915,62.738,"4,705,426",72846,375,2524,160
8/19/13,37922,2369837,65.704,"4,771,130",73299,453,1395,236
8/20/13,41155,2410992,72.697,"4,843,827",73703,404,1491,233
8/21/13,41718,2452710,73.198,"4,917,024",74080,377,1365,176
8/22/13,30747,2483457,51.255,"4,968,280",74400,320,787,128
8/23/13,38716,2522173,72.175,"5,040,455",74713,313,1965,157
8/24/13,38049,2560222,81.052,"5,121,507",75012,299,3933,194
8/25/13,36641,2596863,80.733,"5,202,240",75372,360,3626,199
8/26/13,34812,2631675,61.473,"5,263,713",75756,384,1098,190
8/27/13,39258,2670933,67.086,"5,330,798",76123,367,1222,188
8/28/13,32262,2703195,53.456,"5,384,254",76402,279,765,102
8/29/13,38626,2741821,65.917,"5,450,171",76669,267,1363,141
8/30/13,36870,2778691,67.249,"5,517,420",76922,253,1872,165
8/31/13,28547,2807238,60.049,"5,577,469",77133,211,3064,174
9/1/13,28330,2835568,61.096,"5,638,565",77331,198,3273,148
9/2/13,24094,2859662,46.06,"5,684,625",77609,278,1829,121
9/3/13,36963,2896625,62.807,"5,747,431",77997,388,1015,157
9/4/13,42085,2938710,73.701,"5,821,132",78388,391,1263,176
9/5/13,40817,2979527,70.544,"5,891,676",78726,338,1354,185
9/6/13,40930,3020457,72.124,"5,963,800",79010,284,1556,155
9/7/13,38950,3059407,80.08,"6,043,881",79273,263,3600,200
9/8/13,37536,3096943,76.326,"6,120,207",79649,376,3025,182
9/9/13,40539,3137482,70.713,"6,190,920",80049,400,1060,203
9/10/13,42038,3179520,71.115,"6,262,034",80350,301,986,182
9/11/13,40533,3220053,67.437,"6,329,471",80645,295,1046,147
9/12/13,35065,3255118,56.447,"6,385,918",80910,265,756,126
9/13/13,41200,3296318,70.849,"6,456,767",81164,254,1375,145
9/14/13,35363,3331681,69.18,"6,525,948",81370,206,3035,153
9/15/13,35843,3367524,72.551,"6,598,498",81650,280,3010,167
9/16/13,35106,3402630,56.195,"6,654,693",81970,320,781,149
9/17/13,43117,3445747,70.847,"6,725,540",82207,237,971,170
9/18/13,42936,3488683,71.355,"6,796,896",82480,273,1078,152
9/19/13,43920,3532603,73.659,"6,870,554",82735,255,1209,154
9/20/13,43895,3576498,75.094,"6,945,648",82959,224,1631,156
9/21/13,35348,3611846,70.321,"7,015,969",83161,202,3096,132
9/22/13,33105,3644951,64.758,"7,080,726",83412,251,2479,136
9/23/13,38963,3683914,64.157,"7,144,883",83689,276,1006,171
9/24/13,42954,3726868,70.402,"7,215,286",83922,233,1158,153
9/25/13,42639,3769507,70.5,"7,285,786",84130,208,966,133
9/26/13,42247,3811754,68.646,"7,354,431",84305,175,973,117
9/27/13,41368,3853122,68.977,"7,423,409",84519,213,1321,137
9/28/13,38939,3892061,78.4,"7,501,809",84712,193,3452,126
9/29/13,36040,3928101,70.652,"7,572,461",84913,201,2718,161
9/30/13,41079,3969180,67.168,"7,639,629",85236,323,1023,140Date,Trips over the past 24-hours (midnight to 11:59pm),Cumulative trips (since launch):,Miles traveled today (midnight to 11:59 pm),Miles traveled to date:,Total Annual Members,Annual Member Sign-Ups (midnight to 11:59 pm),"24-Hour Passes Purchased (midnight to 11:59 pm)	7-Day Passes Purchased (midnight to 11:59 pm)"
10/1/13,44772,4013952,73.665,"7,713,294",85494,258,1004
10/2/13,45667,4059619,76.149,"7,789,442",85773,279,1129
10/3/13,44472,4104091,72.635,"7,862,077",86333,560,1076
10/4/13,44089,4148180,74.223,"7,936,300",87112,779,1434
10/5/13,37683,4185863,73.892,"8,010,192",87862,750,2971
10/6/13,29029,4214892,49.887,"8,060,079",88604,742,1368
10/7/13,27504,4242396,40.324,"8,100,403",89189,585,421
10/8/13,42200,4284596,69.116,"8,169,518",89521,332,896
10/9/13,40607,4325203,62.214,"8,231,732",89769,248,714
10/10/13,34107,4359310,49.732,"8,281,464",89951,182,482
10/11/13,36381,4395691,56.497,"8,337,961",90121,170,798
10/12/13,35480,4431171,69.841,"8,407,802",90301,180,2855
10/13/13,31501,4462672,59.556,"8,467,357",90522,221,2208
10/14/13,36186,4498858,60.261,"8,527,618",90770,248,1291
10/15/13,41459,4540317,66.625,"8,594,243",90977,207,934
10/16/13,40644,4580961,64.115,"8,658,358",91171,194,789
10/17/13,40363,4621324,63.927,"8,722,285",91343,172,815
10/18/13,41775,4663099,69.165,"8,791,450",91551,208,1267
10/19/13,32469,4695568,59.523,"8,850,973",91659,108,2146
10/20/13,32016,4727584,60.67,"8,911,643",91815,156,2114
10/21/13,38348,4765932,62.216,"8,973,859",92029,214,849
10/22/13,39741,4805673,60.424,"9,034,282",92213,184,636
10/23/13,35358,4841031,50.319,"9,084,602",92324,111,355
10/24/13,35238,4876269,50.61,"9,135,212",92410,86,444
10/25/13,33711,4909980,50.109,"9,185,320",92505,95,592
10/26/13,26653,4936633,45.372,"9,230,693",92598,93,1387
10/27/13,25980,4962613,44.415,"9,275,108",92698,100,1362
10/28/13,34298,4996911,52.643,"9,327,752",92844,146,530
10/29/13,36280,5033191,53.765,"9,381,516",92944,100,450
10/30/13,37817,5071008,54.94,"9,436,457",93035,91,453
10/31/13,33991,5104999,51.283,"9,487,740",93137,102,464
11/1/13,33193,5138192,52.035,"9,539,774",93221,84,848
11/2/13,33688,5171880,64.833,"9,604,607",93320,94,2434
11/3/13,22414,5194294,34.853,"9,639,461",93424,104,831
11/4/13,29474,5223768,42.802,"9,682,263",93495,71,429
11/5/13,34179,5257947,49.677,"9,731,940",93598,103,471
11/6/13,37785,5295732,58.125,"9,790,064",93706,108,627
11/7/13,27849,5323581,38.518,"9,828,583",93804,93,221
11/8/13,31032,5354613,45.872,"9,874,455",93859,61,456
11/9/13,23522,5378135,39.116,"9,913,570",93918,59,1121
11/10/13,21270,5399405,33.486,"9,947,057",93969,51,952
11/11/13,29544,5428949,43.019,"9,990,076",94061,92,438
11/12/13,21505,5450454,27.48,"10,017,556",94127,66,111
11/13/13,25504,5475958,33.933,"10,051,489",94189,62,157
11/14/13,29194,5505152,40.663,"10,092,152",94250,61,274
11/15/13,31526,5536678,47.207,"10,139,359",94305,55,601
11/16/13,27208,5563886,48.1,"10,187,459",94361,56,1696
11/17/13,19397,5583283,29.366,"10,216,825",94425,64,652
11/18/13,33718,5617001,52.401,"10,269,226",94533,108,515
11/19/13,29633,5646634,40.023,"10,309,249",94593,60,198
11/20/13,28286,5674920,37.925,"10,347,174",94652,59,252
11/21/13,31089,5706009,43.428,"10,390,602",94697,51,289
11/22/13,27503,5733512,38.76,"10,429,362",94739,42,352
11/23/13,20396,5753908,31.638,"10,461,001",94768,29,858
11/24/13,10069,5763977,12.248,"10,473,249",94808,40,137
11/25/13,20649,5784626,26.562,"10,499,811",94843,35,118
11/26/13,16206,5800832,20.283,"10,520,094",94873,30,89
11/27/13,8615,5809447,10.329,"10,530,423",94897,24,49
11/28/13,5668,5815115,8.377,"10,538,800",94912,15,211
11/29/13,10967,5826082,15.406,"10,554,207",94928,16,351
11/30/13,10605,5836687,15.508,"10,569,715",94955,27,401
12/1/13,14322,5851009,21.121,"10,590,837",94997,42,456
12/2/13,26522,5877531,37.728,"10,628,564",95071,74,240
12/3/13,29766,5907297,42.165,"10,670,729",95140,69,252
12/4/13,30472,5937769,43.92,"10,714,650",95197,57,252
12/5/13,29222,5966991,41.99,"10,756,639",95250,53,311
12/6/13,11626,5978617,14.674,"10,771,314",95296,46,62
12/7/13,16868,5995485,24.381,"10,795,695",95334,38,456
12/8/13,10892,6006377,14.17,"10,809,865",95354,20,180
12/9/13,16192,6022569,20.537,"10,830,402",95401,35,58
12/10/13,13947,6036516,17.766,"10,848,168",95418,34,39
12/11/13,20369,6056885,25.839,"10,874,007",95444,26,93
12/12/13,18552,6075437,23.242,"10,897,249",95479,35,69
12/13/13,19381,6094818,25.662,"10,922,911",95507,28,161
12/14/13,3983,6098801,5.072,"10,927,983",95516,9,39
12/15/13,8127,6106928,10.192,"10,938,175",95535,19,76
12/16/13,16842,6123770,21.353,"10,959,528",95568,33,67
12/17/13,8552,6132322,11.009,"10,970,536",95596,28,15
12/18/13,16246,6148568,21.251,"10,991,787",95628,32,89
12/19/13,20309,6168877,26.954,"11,018,742",95662,34,157
12/20/13,23849,6192726,33.51,"11,052,252",95687,25,365
12/21/13,19362,6212088,32.36,"11,084,612",95723,36,962
12/22/13,16338,6228426,26.291,"11,110,903",95765,42,741
12/23/13,7516,6235942,9.407,"11,120,309",95793,28,70
12/24/13,11971,6247913,15.563,"11,135,872",95823,30,175
12/25/13,3523,6251436,5.458,"11,141,330",95869,46,184
12/26/13,10570,6262006,13.556,"11,154,886",95920,51,134
12/27/13,12649,6274655,17.629,"11,172,515",95969,49,279
12/28/13,12867,6287522,21.988,"11,194,503",96005,36,821
12/29/13,4070,6291592,4.986,"11,199,489",96032,27,104
12/30/13,14222,6305814,19.982,"11,219,471",96084,52,336
12/31/13,11349,6317163,14.856,"11,234,326",96125,41,237Date,Trips over the past 24-hours (midnight to 11:59pm),Cumulative trips (since launch):,Miles traveled today (midnight to 11:59 pm),Miles traveled to date:,Total Annual Members,Annual Member Sign-Ups (midnight to 11:59 pm),24-Hour Passes Purchased (midnight to 11:59 pm),7-Day Passes Purchased (midnight to 11:59 pm)
1/1/14,6559,6323722,9.254,"11,243,581",95971,29,268,10
1/2/14,9334,6333056,11.736,"11,255,317",96000,42,66,3
1/3/14,1288,6334344,1.855,"11,257,172",96042,23,1,1
1/4/14,2494,6336838,3.706,"11,260,878",96065,19,14,1
1/5/14,2937,6339775,3.72,"11,264,598",96084,18,17,4
1/6/14,10481,6350256,13.016,"11,277,613",96102,22,30,7
1/7/14,7144,6357400,8.2,"11,285,814",96124,28,5,4
1/8/14,10162,6367562,11.768,"11,297,582",96152,19,28,4
1/9/14,14571,6382133,18.401,"11,315,983",96171,18,74,10
1/10/14,10685,6392818,13.433,"11,329,416",96189,36,49,5
1/11/14,8333,6401151,10.735,"11,340,151",96225,22,101,16
1/12/14,13549,6414700,19.141,"11,359,291",96247,29,350,22
1/13/14,22377,6437077,30.829,"11,390,121",96276,72,224,31
1/14/14,10849,6447926,13.271,"11,403,392",96348,43,45,4
1/15/14,23500,6471426,32.303,"11,435,695",96391,62,241,30
1/16/14,21528,6492954,28.807,"11,464,502",96453,56,208,37
1/17/14,21840,6514794,30.773,"11,495,275",96509,67,282,34
1/18/14,10222,6525016,14.596,"11,509,870",96576,40,176,15
1/19/14,9768,6534784,13.591,"11,523,461",96616,38,194,13
1/20/14,14581,6549365,20.103,"11,543,564",96654,47,133,11
1/21/14,4171,6553536,5.429,"11,548,993",96701,32,5,1
1/22/14,2762,6556298,4.061,"11,553,054",96733,8,4,3
1/23/14,5743,6562041,8.336,"11,561,390",96741,16,9,1
1/24/14,6901,6568942,9.375,"11,570,765",96757,13,15,6
1/25/14,4716,6573658,6.004,"11,576,770",96770,14,34,0
1/26/14,5462,6579120,6.691,"11,583,461",96784,20,37,6
1/27/14,14304,6593424,18.127,"11,601,588",96804,26,55,18
1/28/14,11066,6604490,13.722,"11,615,310",96830,22,18,7
1/29/14,10838,6615328,13.394,"11,628,704",96852,33,21,6
1/30/14,13198,6628526,16.914,"11,645,618",96885,27,42,7
1/31/14,15886,6644412,21.541,"11,667,159",96912,23,130,10
2/1/14,13797,6658209,20.707,"11,687,866",96935,23,349,29
2/2/14,15009,6673218,22.915,"11,710,781",96958,40,449,10
2/3/14,2839,6676057,3.635,"11,714,416",96998,27,4,2
2/4/14,9551,6685608,12.708,"11,727,124",97025,21,37,2
2/5/14,3076,6688684,4.603,"11,731,727",97046,15,8,1
2/6/14,8227,6696911,12.641,"11,744,368",97061,21,25,9
2/7/14,9473,6706384,14.206,"11,758,574",97082,12,36,5
2/8/14,6640,6713024,9.563,"11,768,137",97094,15,71,1
2/9/14,5527,6718551,7.806,"11,775,942",97109,19,47,6
2/10/14,7643,6726194,10.867,"11,786,809",97128,26,16,3
2/11/14,9258,6735452,12.57,"11,799,379",97154,20,22,4
2/12/14,9531,6744983,12.691,"11,812,070",97174,10,24,3
2/13/14,978,6745961,1.725,"11,813,795",97184,7,3,1
2/14/14,4029,6749990,6.586,"11,820,381",97191,14,16,8
2/15/14,2512,6752502,3.834,"11,824,215",97205,16,23,2
2/16/14,3362,6755864,5.063,"11,829,278",97221,12,34,2
2/17/14,5433,6761297,8.226,"11,837,504",97233,10,40,10
2/18/14,5727,6767024,8.393,"11,845,896",97243,19,19,2
2/19/14,9485,6776509,14.086,"11,859,983",97262,18,45,6
2/20/14,12971,6789480,18.707,"11,878,690",97280,27,103,11
2/21/14,9545,6799025,12.423,"11,891,113",97307,34,59,8
2/22/14,14261,6813286,25.945,"11,917,058",97341,38,730,31
2/23/14,14567,6827853,25.298,"11,942,356",97379,56,666,35
2/24/14,14119,6841972,19.238,"11,961,594",97435,76,79,10
2/25/14,14003,6855975,17.699,"11,979,293",97511,45,50,14
2/26/14,12168,6868143,15.039,"11,994,332",97556,28,35,7
2/27/14,13138,6881281,16.042,"12,010,374",97584,28,54,10
2/28/14,10483,6891764,13.017,"12,023,391",97612,38,46,12
3/1/14,9944,6901708,14.364,"12,037,756",97650,37,255,11
3/2/14,9017,6910725,12.288,"12,050,044",97687,40,196,12
3/3/14,8618,6919343,12.02,"12,062,064",97727,41,44,3
3/4/14,11494,6930837,14.473,"12,076,537",97768,39,36,11
3/5/14,14934,6945771,19.147,"12,095,684",97807,62,90,13
3/6/14,13758,6959529,17.12,"12,112,804",97869,38,50,7
3/7/14,14736,6974265,19.809,"12,132,613",97907,63,108,10
3/8/14,18119,6992384,34.814,"12,167,427",97970,82,1211,46
3/9/14,13300,7005684,20.468,"12,187,894",98052,94,496,32
3/10/14,18844,7024528,25.777,"12,213,671",98146,115,206,30
3/11/14,26436,7050964,41.688,"12,255,359",98261,187,574,66
3/12/14,16273,7067237,21.803,"12,277,162",98448,124,153,21
3/13/14,12164,7079401,15.663,"12,292,825",98572,67,55,7
3/14/14,17745,7097146,23.539,"12,316,364",98639,77,209,14
3/15/14,19664,7116810,35.302,"12,351,665",98716,111,1316,54
3/16/14,10740,7127550,16.054,"12,367,720",98827,77,274,31
3/17/14,13681,7141231,17.722,"12,385,442",98904,91,106,19
3/18/14,18046,7159277,24.985,"12,410,427",98995,87,181,30
3/19/14,14387,7173664,19.079,"12,429,506",99082,78,87,19
3/20/14,21299,7194963,31.018,"12,460,523",99160,120,292,36
3/21/14,22266,7217229,33.189,"12,493,712",99280,149,386,26
3/22/14,21671,7238900,42.206,"12,535,919",99429,134,1525,55
3/23/14,12846,7251746,19.105,"12,555,024",99563,115,451,19
3/24/14,14729,7266475,18.838,"12,573,862",99678,84,105,20
3/25/14,17388,7283863,22.135,"12,595,997",99762,79,108,19
3/26/14,15538,7299401,19.368,"12,615,365",99841,72,91,16
3/27/14,18166,7317567,25.302,"12,640,668",99913,78,164,17
3/28/14,20025,7337592,29.858,"12,670,526",99991,81,255,29
3/29/14,4870,7342462,6.546,"12,677,072",100072,55,142,0
3/30/14,8645,7351107,13.365,"12,690,437",100127,93,209,15
3/31/14,18686,7369793,26.78,"12,717,217",100220,117,276,47Date,Trips over the past 24-hours (midnight to 11:59pm),Cumulative trips (since launch):,Miles traveled today (midnight to 11:59 pm),Miles traveled to date:,Total Annual Memberships Sold,Annual Member Sign-Ups (midnight to 11:59 pm),24-Hour Passes Purchased (midnight to 11:59 pm),7-Day Passes Purchased (midnight to 11:59 pm)
4/1/14,26163,7395956,40.978,"12,758,196",100337,174,475,67
4/2/14,24299,7420255,35.54,"12,793,736",100511,118,237,33
4/3/14,28379,7448634,44.649,"12,838,385",100629,171,596,63
4/4/14,13593,7462227,17.644,"12,856,030",100800,92,103,10
4/5/14,20333,7482560,36.797,"12,892,827",100892,127,1221,42
4/6/14,22643,7505203,45.575,"12,938,402",101019,165,1641,62
4/7/14,15869,7521072,21.9,"12,960,303",101184,131,159,36
4/8/14,23636,7544708,34.85,"12,995,153",101315,126,369,44
4/9/14,29194,7573902,45.619,"13,040,772",101441,201,447,57
4/10/14,29722,7603624,46.023,"13,086,794",101642,172,525,65
4/11/14,29283,7632907,49.269,"13,136,064",101814,140,632,83
4/12/14,29773,7662680,63.649,"13,199,713",101954,175,2710,89
4/13/14,29521,7692201,65.746,"13,265,459",102129,228,2411,109
4/14/14,31732,7723933,57.307,"13,322,766",102357,266,993,114
4/15/14,11370,7735303,14.639,"13,337,404",102623,128,73,19
4/16/14,21713,7757016,31.427,"13,368,832",102751,132,279,50
4/17/14,24190,7781206,36.642,"13,405,474",102883,113,470,53
4/18/14,22409,7803615,33.846,"13,439,319",102996,98,628,60
4/19/14,26541,7830156,59.461,"13,498,781",103094,118,2666,99
4/20/14,20122,7850278,40.814,"13,539,595",103212,154,1639,84
4/21/14,29618,7879896,50.57,"13,590,165",103366,276,839,105
4/22/14,29580,7909476,45.813,"13,635,978",103642,169,560,58
4/23/14,29341,7938817,44.266,"13,680,243",103811,173,358,68
4/24/14,30515,7969332,48.329,"13,728,573",103984,160,646,95
4/25/14,30299,7999631,49.915,"13,778,488",104144,126,767,56
4/26/14,21785,8021416,42.759,"13,821,247",104270,118,1720,57
4/27/14,24093,8045509,46.188,"13,867,436",104388,156,1616,84
4/28/14,31279,8076788,51.168,"13,918,604",104544,176,744,94
4/29/14,20003,8096791,26.84,"13,945,444",104720,120,160,24
4/30/14,3093,8099884,3.572,"13,949,016",104840,63,15,0
5/1/14,29448,8129332,51.32,"14,000,335",104903,138,780,94
5/2/14,35590,8164922,60.514,"14,060,849",105041,192,1192,144
5/3/14,28254,8193176,61.95,"14,122,799",105233,152,2440,150
5/4/14,23450,8216626,43.926,"14,166,724",105385,159,1479,77
5/5/14,33706,8250332,58.904,"14,225,628",105544,219,842,127
5/6/14,35977,8286309,62.455,"14,288,083",105763,197,836,100
5/7/14,36210,8322519,58.617,"14,346,700",105960,195,799,91
5/8/14,19518,8342037,28.9,"14,375,600",106155,105,303,20
5/9/14,24990,8367027,37.118,"14,412,718",106260,111,537,59
5/10/14,24179,8391206,44.945,"14,457,663",106371,133,1617,74
5/11/14,31551,8422757,71.587,"14,529,250",106504,161,2768,145
5/12/14,35209,8457966,61.465,"14,590,714",106665,246,935,124
5/13/14,36281,8494247,59.204,"14,649,918",106911,204,737,125
5/14/14,33087,8527334,52.063,"14,701,982",107115,164,586,75
5/15/14,28847,8556181,45.347,"14,747,329",107279,129,566,76
5/16/14,19561,8575742,27.664,"14,774,993",107408,114,218,22
5/17/14,33141,8608883,71.372,"14,846,365",107522,130,2968,141
5/18/14,30026,8638909,61.977,"14,908,341",107652,154,2476,124
5/19/14,34763,8673672,56.666,"14,965,008",107806,226,914,124
5/20/14,38928,8712600,66.578,"15,031,586",108032,194,1145,141
5/21/14,37493,8750093,61.069,"15,092,655",108226,146,897,115
5/22/14,26753,8776846,39.65,"15,132,305",108372,121,470,40
5/23/14,26895,8803741,42.128,"15,174,433",108493,108,793,84
5/24/14,18503,8822244,35.805,"15,210,238",108601,109,1532,105
5/25/14,28266,8850510,68.798,"15,279,036",108710,115,3535,144
5/26/14,29819,8880329,70.712,"15,349,748",108825,169,3095,143
5/27/14,36165,8916494,63.451,"15,413,199",108994,253,1196,162
5/28/14,32666,8949160,49.67,"15,462,869",109247,164,533,79
5/29/14,37184,8986344,60.222,"15,523,091",109411,144,930,108
5/30/14,37875,9024219,65.24,"15,588,331",109555,167,1191,118
5/31/14,30659,9054878,61.976,"15,650,307",109722,139,2305,129
6/1/14,34597,9089475,75.594,"15,725,901",109861,212,2912,168
6/2/14,38143,9127618,68.186,"15,794,087",110073,277,1099,150
6/3/14,32504,9160122,52.767,"15,846,854",110350,238,702,119
6/4/14,39747,9199869,66.953,"15,913,807",110588,170,950,135
6/5/14,27165,9227034,44.714,"15,958,521",110758,146,692,81
6/6/14,41291,9268325,72.887,"16,031,408",110904,164,1668,128
6/7/14,34417,9302742,74.549,"16,105,957",111068,116,2888,165
6/8/14,33432,9336174,73.196,"16,179,153",111184,162,2704,117
6/9/14,20545,9356719,32.252,"16,211,405",111346,127,394,43
6/10/14,36959,9393678,59.916,"16,271,321",111473,167,783,117
6/11/14,33809,9427487,55.193,"16,326,514",111640,121,691,105
6/12/14,32186,9459673,49.272,"16,375,786",111761,134,644,78
6/13/14,20236,9479909,31.146,"16,406,932",111895,106,565,40
6/14/14,31432,9511341,63.83,"16,470,762",112001,106,2442,129
6/15/14,31029,9542370,65.14,"16,535,902",112107,142,2397,136
6/16/14,38568,9580938,66.964,"16,602,866",112249,200,1080,153
6/17/14,38963,9619901,66.789,"16,669,655",112449,173,978,124
6/18/14,38984,9658885,64.305,"16,733,960",112622,161,905,139
6/19/14,35327,9694212,58.66,"16,792,620",112783,113,812,92
6/20/14,38827,9733039,78.661,"16,871,281",112896,164,1439,117
6/21/14,33325,9766364,69.714,"16,940,995",113060,94,2951,149
6/22/14,32300,9798664,65.036,"17,006,031",113154,135,2532,107
6/23/14,36342,9835006,61.529,"17,067,560",113289,193,1024,167
6/24/14,39886,9874892,66.604,"17,134,164",113482,173,939,136
6/25/14,38035,9912927,60.763,"17,194,927",113655,129,868,137
6/26/14,38610,9951537,63.768,"17,258,695",113784,121,1051,109
6/27/14,39697,9991234,70.902,"17,329,597",113905,115,1573,147
6/28/14,31684,10022918,65.075,"17,394,672",114020,122,2679,125
6/29/14,30784,10053702,64.706,"17,459,378",114142,118,2450,125
6/30/14,36854,10090556,61.917,"17,521,295",114260,174,1044,120Date,Trips over the past 24-hours (midnight to 11:59pm),Cumulative trips (since launch):,Miles traveled today (midnight to 11:59 pm),Miles traveled to date:,Total Annual Memberships Sold,Annual Member Sign-Ups (midnight to 11:59 pm),24-Hour Passes Purchased (midnight to 11:59 pm),7-Day Passes Purchased (midnight to 11:59 pm)
7/1/14,37970,10128526,61.17,"17,582,465",114434,126,955,120
7/2/14,28765,10157291,44.192,"17,626,657",114560,160,688,92
7/3/14,30078,10187369,48.573,"17,675,230",114720,124,819,88
7/4/14,14850,10202219,27.905,"17,703,135",114844,48,1196,77
7/5/14,25116,10227335,55.725,"17,758,860",114892,86,2566,127
7/6/14,26615,10253950,65.358,"17,824,218",114978,114,2392,111
7/7/14,35075,10289025,59.834,"17,884,052",115092,195,905,160
7/8/14,35734,10324759,57.828,"17,941,880",115287,171,740,120
7/9/14,37588,10362347,60.912,"18,002,792",115446,159,879,127
7/10/14,39779,10402126,66.239,"18,069,031	",115605,159,1052,115
7/11/14,38416,10440542,65.516,"18,134,547",115711,106,1339,93
7/12/14,31413,10471955,63.664,"18,198,211",115810,99,2697,115
7/13/14,27089,10499044,50.105,"18,248,316",115914,104,1713,91
7/14/14,28173,10527217,43.222,"18,291,538",116026,112,637,93
7/15/14,24993,10552210,37.092,"18,328,630",116142,116,410,58
7/16/14,38610,10590820,63.616,"18,392,246",116245,103,959,116
7/17/14,41996,10632816,70.061,"18,462,307",116361,116,1114,110
7/18/14,39526,10672342,69.416,"18,531,723	",116472,111,1502,148
7/19/14,31943,10704285,64.395,"18,596,118",116551,79,2796,130
7/20/14,33156,10737441,68.542,"18,664,660",116669,118,2767,146
7/21/14,38963,10776404,64.824,"18,729,484",116812,143,1162,129
7/22/14,40450,10816854,67.081,"18,796,565",116969,157,992,127
7/23/14,37508,10854362,59.956,"18,856,521",117090,121,816,126
7/24/14,40419,10894781,67.584,"18,924,105",117229,139,1064,109
7/25/14,39768,10934549,68.652,"18,992,757",117340,111,1457,105
7/26/14,29882,10964431,59.645,"19,052,402",117427,87,2428,92
7/27/14,29669,10994100,58.193,"19,110,595",117530,103,2108,115
7/28/14,36360,11030460,59.567,"19,170,162	",117703,173,877,150
7/29/14,41198,11071658,68.064,"19,238,226",117930,227,1089,128
7/30/14,41207,11112865,68.127,"19,306,353",118075,145,1116,99
7/31/14,39282,11152147,65.414,"19,371,767",118204,129,1065,113
8/1/14,35829,11187976,59.202,"19,430,969",118314,110,1192,93
8/2/14,30013,11217989,60.544,"19,490,171",118408,94,2540,127
8/3/14,27854,11245843,55.867,"19,546,038",118555,147,2146,96
8/4/14,37408,11283251,63.737,"19,609,775",118704,149,1097,165
8/5/14,38168,11321419,63.957,"19,673,732",118830,126,1059,119
8/6/14,39942,11361361,66.342,"19,740,074",118938,108,1067,144
8/7/14,39933,11401294,67.398,"19,807,472",119047,109,1083,129
8/8/14,37367,11438661,64.33,"19,871,802",119137,90,1342,111
8/9/14,35701,11474362,81.003,"19,952,805",119244,107,3814,151
8/10/14,29339,11503701,61.287,"20,014,092",119351,107,2303,131
8/11/14,36837,11540538,61.708,"20,075,800",119495,144,1167,132
8/12/14,28591,11569129,41.88,"20,117,680",119584,89,526,90
8/13/14,30698,11599827,49.367,"20,167,047",119693,109,661,98
8/14/14,38863,11638690,67.924,"20,234,971",119789,96,1069,128
8/15/14,35524,11674214,60015,20294986,119869,80,1198,117
8/16/14,36127,11710341,83272,20378258,119962,93,4217,155
8/17/14,30223,11740564,61390,20439648,120069,107,2344,121
8/18/14,37851,11778415,64873,20504521,120227,158,1156,157
8/19/14,38912,11817327,65883,20570404,120356,129,965,140
8/20/14,39090,11856417,66900,20637304,120470,114,1057,110
8/21/14,36917,11893334,62373,20699677,120598,128,960,107
8/22/14,33147,11926481,54765,20754442,120688,90,863,81
8/23/14,28956,11955437,57270,20811712,120769,81,2254,98
8/24/14,30422,11985859,65005,20876717,120884,115,2528,125
8/25/14,36244,12022103,60866,20937583,121050,166,1007,146
8/26/14,37937,12060040,62487,21000070,121157,107,937,124
8/27/14,36900,12096940,61488,21061558,121292,135,829,83
8/28/14,37055,12133995,62402,21123960,121423,131,982,83
8/29/14,34292,12168287,59371,21183331,121522,99,1329,109
8/30/14,25239,12193526,52782,21236113,121610,88,2442,99
8/31/14,20097,12213623,41594,21277707,121690,80,1952,89
9/1/14,26055,12239678,51270,21328977,121809,119,2083,105
9/2/14,34005,12273683,53842,21382819,121979,170,693,121
9/3/14,38998,12312681,62736,21445555,122124,145,789,148
9/4/14,40022,12352703,64563,21510118,122248,124,816,125
9/5/14,38325,12391028,64421,21574539,122356,108,1111,121
9/6/14,28290,12419318,51519,21626058,122438,82,1674,105
9/7/14,32524,12451842,65394,21691452,122555,117,2222,115
9/8/14,38091,12489933,60610,21752062,122697,142,818,118
9/9/14,38101,12528034,59026,21811088,122818,121,620,99
9/10/14,41634,12569668,69561,21880649,122915,97,981,104
9/11/14,40864,12610532,65798,21946447,123006,91,844,90
9/12/14,41341,12651873,75561,22022008,123111,105,1195,103
9/13/14,19110,12670983,31600,22053608,123192,81,842,67
9/14/14,31589,12702572,62963,22116571,123309,117,2290,117
9/15/14,39044,12741616,64983,22181554,123421,112,858,118
9/16/14,28285,12769901,43250,22224804,123521,100,484,61
9/17/14,41347,12811248,67758,22292562,123636,115,916,121
9/18/14,41145,12852393,67840,22360402,123718,82,887,115
9/19/14,38162,12890555,62500,22422902,123796,78,979,90
9/20/14,32951,12923506,64838,22487740,123850,54,2464,122
9/21/14,28530,12952036,54319,22542059,123926,76,1693,90
9/22/14,36624,12988660,59024,22601083,124044,118,748,84
9/23/14,40105,13028765,66590,22667673,124124,80,841,106
9/24/14,38976,13067741,62834,22730507,124230,106,719,100
9/25/14,18282,13086023,26019,22756526,124291,61,165,24
9/26/14,38394,13124417,66227,22822753,124376,85,1297,118
9/27/14,33322,13157739,69724,22892477,124433,57,2712,118
9/28/14,32080,13189819,64811,22957288,124532,99,2259,129
9/29/14,36896,13226715,59305,23016593,124645,113,689,114
9/30/14,39061,13265776,59970,23076563,124734,89,613,65Date,Trips over the past 24-hours (midnight to 11:59pm),Cumulative trips (since launch):,Miles traveled today (midnight to 11:59 pm),Miles traveled to date:,Total Annual Memberships Sold,Annual Member Sign-Ups (midnight to 11:59 pm),24-Hour Passes Purchased (midnight to 11:59 pm),7-Day Passes Purchased (midnight to 11:59 pm)
10/1/14,31197,13296973,44612,23121175,124846,112,330,48
10/2/14,38286,13335259,60639,23181814,124959,113,602,86
10/3/14,38956,13374215,65739,23247553,125024,65,1276,107
10/4/14,15088,13389303,24254,23271807,125058,34,617,26
10/5/14,26247,13415550,48930,23320737,125109,51,1470,90
10/6/14,35651,13451201,56380,23377117,125203,94,710,99
10/7/14,36931,13488132,58740,23435857,125262,59,593,81
10/8/14,37870,13526002,60594,23496451,125354,92,667,86
10/9/14,36427,13562429,57865,23554316,125407,53,709,71
10/10/14,34690,13597119,54690,23609006,125464,57,905,78
10/11/14,14805,13611924,23278,23632284,125487,23,528,34
10/12/14,26259,13638183,52781,23685064,125529,42,2083,80
10/13/14,25616,13663799,40275,23725339,125589,60,749,60
10/14/14,36529,13700328,61691,23787030,125651,62,869,101
10/15/14,31784,13732112,49319,23836349,125703,52,506,82
10/16/14,29845,13761957,47808,23884157,125763,60,499,61
10/17/14,37759,13799716,64389,23948545,125816,53,1180,105
10/18/14,27634,13827350,52554,24001099,125865,49,1806,63
10/19/14,21017,13848367,35039,24036139,125914,49,1000,57
10/20/14,30928,13879295,48030,24084168,125968,54,514,74
10/21/14,34710,13914005,53960,24138128,126008,40,539,90
10/22/14,10402,13924407,13894,24152022,126037,29,110,30
10/23/14,14886,13939293,20446,24172468,126062,25,74,19
10/24/14,33022,13972315,51151,24223619,126086,24,722,84
10/25/14,27802,14000117,53881,24277499,126117,31,2093,83
10/26/14,23077,14023194,41308,24318808,126166,49,1220,71
10/27/14,31908,14055122,49892,24368754,126229,63,519,73
10/28/14,36429,14091551,56602,24425356,126395,166,628,79
10/29/14,32944,14124495,48378,24473733,126460,65,466,70
10/30/14,34658,14159153,52162,24525895,126487,27,557,61
10/31/14,30787,14189940,46834,24572729,126503,16,653,75
11/1/14,6739,14196679,8703,24581432,126514,11,98,10
11/2/14,15730,14212409,23106,24604538,126527,13,480,44
11/3/14,29590,14241999,45368,24649906,126557,30,568,51
11/4/14,34612,14276611,54306,24704213,126579,22,665,80
11/5/14,33764,14310375,52464,24756677,126611,32,513,49
11/6/14,13882,14324257,18743,24775420,126627,16,98,12
11/7/14,28053,14352310,40163,24815583,126647,20,416,45
11/8/14,19372,14371682,31589,24847172,126659,12,878,40
11/9/14,20225,14391907,34251,24881423,126675,16,952,44
11/10/14,30616,14422523,46768,24928191,126700,25,607,46
11/11/14,32312,14454835,49461,24977651,126719,19,599,41
11/12/14,30830,14485665,45234,25022886,126747,28,325,36
11/13/14,22798,14508463,32395,25055281,126770,23,252,21
11/14/14,23452,14531915,33240,25088520,126783,13,242,28
11/15/14,15403,14547318,23774,25112295,126797,14,522,16
11/16/14,14544,14561862,20645,25132940,126811,14,319,20
11/17/14,8944,14570806,11294,25144234,126823,12,25,8
11/18/14,18436,14589242,23704,25167938,126834,11,78,26
11/19/14,18211,14607453,24052,25191989,126847,13,102,17
11/20/14,22682,14630135,30878,25222867,126858,11,160,20
11/21/14,19582,14649717,25533,25248400,126865,7,131,24
11/22/14,13838,14663555,20211,25268611,126875,10,345,9
11/23/14,17012,14680567,27503,25296114,126886,11,628,26
11/24/14,25007,14705574,37873,25333986,126894,8,374,45
11/25/14,27889,14733463,39495,25373481,126904,10,365,27
11/26/14,4064,14737527,4997,25378478,126908,4,14,1
11/27/14,4331,14741858,5954,25384432,126911,3,74,10
11/28/14,9157,14751015,12743,25397175,126918,7,209,8
11/29/14,8974,14759989,12808,25409983,126924,6,235,14
11/30/14,13612,14773601,21244,25431227,126937,13,449,25
12/1/14,20398,14793999,29977,25461204,126956,19,281,20
12/2/14,16961,14810960,22343,25483547,126970,14,45,24
12/3/14,15078,14826038,23083,25506630,126978,8,65,6
12/4/14,23442,14849480,33077,25539707,126986,8,191,14
12/5/14,17289,14866769,23200,25562908,126992,6,153,12
12/6/14,4487,14871256,5787,25568695,127004,12,59,5
12/7/14,11404,14882660,16007,25584702,127012,8,254,13
12/8/14,17015,14899675,21665,25606367,127024,12,60,11
12/9/14,7322,14906997,9458,25615825,127031,7,18,4
12/10/14,11476,14918473,14590,25630415,127036,5,23,5
12/11/14,19840,14938313,27417,25657832,127041,5,144,19
12/12/14,19393,14957706,25689,25683521,127046,5,151,13
12/13/14,13760,14971466,21276,25704797,127050,4,324,20
12/14/14,13255,14984721,19351,25724148,127058,8,326,20
12/15/14,21306,15006027,29232,25753380,127065,7,186,25
12/16/14,18653,15024680,25116,25778496,127075,10,119,19
12/17/14,22350,15047030,30878,25809373,127085,10,186,18
12/18/14,20679,15067709,27451,25836824,127093,8,119,14
12/19/14,18696,15086405,24828,25861652,127104,11,158,14
12/20/14,10628,15097033,13747,25875399,127116,12,145,7
12/21/14,9582,15106615,12740,25888139,127126,10,170,9
12/22/14,14849,15121464,20321,25908460,127138,12,156,17
12/23/14,10405,15131869,13946,25922406,127146,8,68,9
12/24/14,4716,15136585,6183,25928589,127155,9,36,7
12/25/14,5354,15141939,11023,25939612,127165,10,"	456	41",undefined
12/26/14,10775,15152714,17715,25957327,127183,18,464,63
12/27/14,11128,15163842,21130,25978457,127196,"13	741",58,undefined
12/28/14,8719,15172561,12978,25991435,127222,26,326,23
12/29/14,14763,15187324,22499,26013934,127244,"22	363",37,undefined
12/30/14,13277,15200601,18112,26032046,127258,14,214,31
12/31/14,10450,15211051,14560,26046606,127269,11,216,12Date,Trips over the past 24-hours (midnight to 11:59pm),Cumulative trips (since launch):,Miles traveled today (midnight to 11:59 pm),Miles traveled to date:,Total Annual Members (All Time),24-Hour Passes Purchased (midnight to 11:59 pm),7-Day Passes Purchased (midnight to 11:59 pm)
1/1/15,5792,15216843,9191,26055797,127279,267,11
1/2/15,12371,15229214,18222,26074019,127293,298,8
1/3/15,4834,15234048,6282,26080301,127300,96,7
1/4/15,8509,15242557,11700,26092001,127308,152,5
1/5/15,15792,15258349,20022,26112023,127336,88,12
1/6/15,9483,15267832,12003,26124026,127354,2,1
1/7/15,10685,15278517,12791,26136817,127363,5,1
1/8/15,9777,15288294,11667,26148484,127372,18,0
1/9/15,8631,15296925,11093,26159577,127376,16,2
1/10/15,6826,15303751,8189,26167766,127383,51,3
1/11/15,8204,15311955,10199,26177965,127395,68,8
1/12/15,9441,15321396,11589,26189554,127408,27,2
1/13/15,14134,15335530,17429,26206983,127418,23,10
1/14/15,14396,15349926,18105,26225088,127427,43,7
1/15/15,15463,15365389,19803,26244891,127434,64,8
1/16/15,15059,15380448,19084,26263975,127441,94,14
1/17/15,8243,15388691,10818,26274793,127453,152,3
1/18/15,2038,15390729,2435,26277228,127461,12,0
1/19/15,11913,15402642,15733,26292961,127470,124,11
1/20/15,17615,15420257,22740,26315701,127502,93,9
1/21/15,16734,15436991,21228,26336929,127520,67,16
1/22/15,17435,15454426,22630,26359559,127530,74,9
1/23/15,17080,15471506,22248,26381807,127545,95,14
1/24/15,5275,15476781,6723,26388530,127552,41,2
1/25/15,10235,15487016,14421,26402951,127559,202,4
1/26/15,4537,15491553,5979,26408930,127566,15,0
1/27/15,1405,15492958,2343,26411273,127569,36,1
1/28/15,6223,15499181,9907,26421180,127575,12,2
1/29/15,9845,15509026,14171,26435351,127586,31,3
1/30/15,9943,15518969,12945,26448296,127595,21,6
1/31/15,5752,15524721,7328,26455624,127596,38,2
2/1/15,7214,15531935,9186,26464810,127608,72,8
2/2/15,1686,15533621,2635,26467445,127608,6,0
2/3/15,5443,15539064,7816,26475261,127612,5,1
2/4/15,9854,15548918,13775,26489036,127624,27,1
2/5/15,9977,15558895,12607,26501643,127630,13,1
2/6/15,9334,15568229,11948,26513591,127635,26,4
2/7/15,7346,15575575,10045,26523636,127640,83,7
2/8/15,7180,15582755,9671,26533307,127642,65,7
2/9/15,5717,15588472,7234,26540541,127646,10,3
2/10/15,11289,15599761,14526,26555067,127652,36,5
2/11/15,12453,15612214,16204,26571271,127657,46,12
2/12/15,12651,15624865,16248,26587519,127667,45,4
2/13/15,8595,15633460,10773,26598292,127674,28,2
2/14/15,5124,15638584,6392,26604684,127678,54,2
2/15/15,2837,15641421,3289,26607973,127681,12,0
2/16/15,4500,15645921,5423,26613396,127682,19,2
2/17/15,5289,15651210,6869,26620265,127683,14,2
2/18/15,10001,15661211,12995,26633260,127693,35,6
2/19/15,8485,15669696,10080,26643340,127696,14,0
2/20/15,6825,15676521,8056,26651396,127700,14,3
2/21/15,3453,15679974,4164,26655560,127701,24,5
2/22/15,4654,15684628,6648,26662208,127706,55,4
2/23/15,8343,15692971,10519,26672727,127714,11,8
2/24/15,8483,15701454,10675,26683402,127729,12,1
2/25/15,12057,15713511,15655,26699057,127739,49,5
2/26/15,11047,15724558,14744,26713801,127747,26,7
2/27/15,10861,15735419,14313,26728114,127753,57,10
2/28/15,6836,15742255,8975,26737089,127754,71,3
3/1/15,3169,15745424,4042,26741131,127763,37,4
3/2/15,8019,15753443,10767,26751898,127770,27,3
3/3/15,7178,15760621,9430,26761328,127775,18,2
3/4/15,8265,15768886,10842,26772170,127779,28,4
3/5/15,1821,15770707,2604,26774774,127784,4,0
3/6/15,5953,15776660,8248,26783022,127792,19,6
3/7/15,6255,15782915,8849,26791871,127799,96,9
3/8/15,8711,15791626,13701,26805572,127819,245,16
3/9/15,16365,15807991,24159,26829731,127852,218,24
3/10/15,13080,15821071,17626,26847357,127886,126,17
3/11/15,21728,15842799,33446,26880803,127936,386,29
3/12/15,19246,15862045,26931,26907734,127977,195,22
3/13/15,17850,15879895,24699,26932433,128023,239,27
3/14/15,4302,15884197,5592,26938025,128041,60,5
3/15/15,9676,15893873,13635,26951660,128071,260,31
3/16/15,18476,15912349,26091,26977751,128108,273,35
3/17/15,16287,15928636,22462,27000213,128143,178,21
3/18/15,15050,15943686,11465,27011678,128169,110,15
3/19/15,16699,15960385,16176,27027854,128191,150,14
3/20/15,8786,15969171,11465,27039319,128204,58,6
3/21/15,10236,15979407,16176,27055495,128216,367,23
3/22/15,10638,15990045,16098,27071593,128249,381,10
3/23/15,14669,16004714,18957,27090550,128287,111,25
3/24/15,17532,16022246,23581,27114131,128313,168,34
3/25/15,15851,16038097,21456,27135587,128347,136,22
3/26/15,16193,16054290,22876,27158463,128385,125,25
3/27/15,15433,16069723,21520,27179983,128417,188,19
3/28/15,1255,16070978,1562,27181545,128431,10,2
3/29/15,10585,16081563,17373,27198918,128485,473,27
3/30/15,19250,16100813,26828,27225746,128527,244,53
3/31/15,15199,16116012,20532,27246278,128576,122,38Date,Trips over the past 24-hours (midnight to 11:59pm),Cumulative trips (since launch),Miles traveled today (midnight to 11:59 pm),Miles traveled to date,Total Annual Memberships Sold,24-Hour Passes Purchased (midnight to 11:59 pm),7-Day Passes Purchased (midnight to 11:59 pm)
4/1/15,21566,16137578,31708,27277986,128629,325,34
4/2/15,26346,16163924,43134,27321120,128698,864,65
4/3/15,15978,16179902,23643,27344763,128735,365,27
4/4/15,15538,16195440,27764,27372527,128783,1029,46
4/5/15,14962,16210402,29709,27402236,128846,1208,52
4/6/15,25502,16235904,43529,27445765,128940,1065,73
4/7/15,17640,16253544,24209,27469974,129003,270,33
4/8/15,19223,16272767,26004,27495978,129047,276,30
4/9/15,17723,16290490,23891,27519869,129081,163,20
4/10/15,17648,16308138,25628,27545497,129124,289,37
4/11/15,20451,16328589,39786,27585283,129193,1600,59
4/12/15,21851,16350440,46764,27632047,129273,1951,87
4/13/15,26980,16377420,43753,27675800,129377,603,73
4/14/15,24452,16401872,36555,27712355,129451,334,53
4/15/15,30184,16432056,49727,27762082,129541,733,84
4/16/15,29273,16461329,45915,27807997,129639,617,57
4/17/15,26164,16487493,42203,27850200,129717,671,81
4/18/15,31024,16518517,71371,27921571,129802,3685,138
4/19/15,23444,16541961,46416,27967987,129901,1851,103
4/20/15,12080,16554041,16377,27984364,129974,96,23
4/21/15,27057,16581098,43508,28027872,130039,608,88
4/22/15,23893,16604991,35999,28063871,130109,374,51
4/23/15,23886,16628877,34259,28098130,130168,311,61
4/24/15,22605,16651482,32678,28130808,130211,421,37
4/25/15,22963,16674445,46054,28176862,130293,2095,85
4/26/15,23608,16698053,48664,28225526,130378,1999,128
4/27/15,27657,16725710,43197,28268723,130486,609,99
4/28/15,32481,16758191,54129,28322852,130575,893,98
4/29/15,34427,16792618,59166,28382018,130671,1087,150
4/30/15,31756,16824374,51077,28433095,130745,785,102
5/1/15,30345,16854719,48736,28481831,130840,917,106
5/2/15,28295,16883014,60188,28542019,130899,2799,138
5/3/15,30446,16913460,69728,28611747,130992,3361,154
5/4/15,35115,16948575,63531,28675278,131145,1397,191
5/5/15,35990,16984565,60088,28735366,131284,987,145
5/6/15,32788,17017353,50987,28786353,131366,712,90
5/7/15,37762,17055115,64189,28850542,131496,1271,133
5/8/15,37206,17092321,64255,28914797,131607,1596,170
5/9/15,26813,17119134,51941,28966738,131677,2077,158
5/10/15,28962,17148096,62364,29029102,131752,2444,189
5/11/15,35068,17183164,57873,29086975,131884,1084,198
5/12/15,38186,17221350,62939,29149914,131979,1103,179
5/13/15,36162,17257512,57091,29207005,132074,891,119
5/14/15,44429,17301941,80286,29287291,132158,4927,82
5/15/15,37687,17339628,64660,29351951,132225,1665,181
5/16/15,26142,17365770,50862,29402813,132293,2392,155
5/17/15,34006,17399776,73458,29476271,132357,3499,189
5/18/15,33527,17433303,53794,29530065,132470,1031,129
5/19/15,36272,17469575,58026,29588091,132561,943,177
5/20/15,36020,17505595,57290,29645381,132643,923,100
5/21/15,33076,17538671,50277,29695658,132711,746,105
5/22/15,33898,17572569,58351,29754009,132765,1356,150
5/23/15,25985,17598554,56999,29811008,132798,2967,166
5/24/15,27400,17625954,66211,29877219,132839,3689,156
5/25/15,30636,17656590,69099,29946318,132914,3392,221
5/26/15,38282,17694872,64504,30010822,133006,1202,188
5/27/15,35952,17730824,57511,30068333,133080,879,124
5/28/15,38291,17769115,61662,30129995,133153,1014,144
5/29/15,40179,17809294,69343,30199338,133217,1648,134
5/30/15,33503,17842797,69481,30268819,133265,3082,192
5/31/15,21196,17863993,40580,30309399,133339,1606,105
6/1/15,16079,17880072,20369,30329768,133401,162,41
6/2/15,12706,17892778,15730,30345498,133453,75,35
6/3/15,36345,17929123,58749,30404247,133535,1129,143
6/4/15,34390,17963513,52792,30457039,133598,806,147
6/5/15,32861,17996374,51079,30508118,133641,959,117
6/6/15,27910,18024284,55613,30563731,133687,2457,144
6/7/15,32881,18057165,71994,30635725,133752,3295,169
6/8/15,35453,18092618,58140,30693865,133832,1045,168
6/9/15,37322,18129940,59489,30753354,133896,889,140
6/10/15,41386,18171326,69035,30822389,133964,1223,140
6/11/15,39083,18210409,62993,30885382,134041,1060,137
6/12/15,36801,18247210,60933,30946315,134109,1374,131
6/13/15,31772,18278982,67103,31013418,134156,3045,168
6/14/15,29829,18308811,62977,31076395,134220,2633,192
6/15/15,26533,18335344,38705,31115100,134279,575,122
6/16/15,33832,18369176,52864,31167964,134345,798,151
6/17/15,40009,18409185,65208,31233172,134414,1145,160
6/18/15,37326,18446511,56562,31289734,134468,792,144
6/19/15,39350,18485861,66914,31356648,134516,1543,143
6/20/15,24937,18510798,45872,31402520,134548,1747,125
6/21/15,27486,18538284,55513,31458033,134602,2295,140
6/22/15,39758,18578042,66659,31524692,134676,1282,202
6/23/15,34182,18612224,52805,31577497,134743,824,147
6/24/15,43484,18655708,73125,31650622,134818,1270,189
6/25/15,41618,18697326,68362,31718984,134859,1166,135
6/26/15,40599,18737925,68529,31787513,134908,1579,182
6/27/15,16271,18754196,28233,31815746,134935,1143,65
6/28/15,21588,18775784,42273,31858019,134975,1610,101
6/29/15,39785,18815569,69309,31927328,135065,1452,196
6/30/15,39839,18855408,65564,31992892,135136,1220,156Date,Trips over the past 24-hours (midnight to 11:59pm),Cumulative trips (since launch):,Miles traveled today (midnight to 11:59 pm),Miles traveled to date:,Total Annual Memberships Sold,24-Hour Passes Purchased (midnight to 11:59 pm),7-Day Passes Purchased (midnight to 11:59 pm)
7/1/15,39019,18894427,64472,32057364,135204,1251,142
7/2/15,36962,18931389,62434,32119798,135247,1411,175
7/3/15,27821,18959210,58884,32178682,135294,2818,173
7/4/15,22347,18981557,53110,32231792,135326,3036,130
7/5/15,26708,19008265,61185,32292977,135384,2829,180
7/6/15,36174,19044439,62539,32355516,135470,1287,224
7/7/15,37930,19082369,63163,32418679,135548,1071,200
7/8/15,35900,19118269,57751,32476430,135594,823,139
7/9/15,32734,19151003,52402,32528832,135646,900,122
7/10/15,39687,19190690,71490,32600322,135704,1724,143
7/11/15,32620,19223310,69705,32670027,135755,3190,178
7/12/15,31853,19255163,68158,32738185,135809,2875,166
7/13/15,39586,19294749,67998,32806250,135890,1273,238
7/14/15,36671,19331420,58900,32865150,135966,754,145
7/15/15,35855,19367275,57781,32922931,136023,873,111
7/16/15,43302,19410577,76535,32999466,136092,1676,197
7/17/15,40782,19451359,73884,33073350,136144,1815,161
7/18/15,29619,19480978,61739,33135089,136188,2800,165
7/19/15,29332,19510310,61512,33196601,136244,2709,169
7/20/15,35960,19546270,59568,33256169,136315,1052,205
7/21/15,39557,19585827,66191,33322360,136379,1234,170
7/22/15,43602,19629429,75758,33398118,136460,1363,179
7/23/15,43319,19672748,75512,33473630,136528,1404,166
7/24/15,41201,19713949,72841,33546471,136594,1778,174
7/25/15,32458,19746407,73133,33619604,136655,3535,148
7/26/15,31325,19777732,66278,33685882,136721,2889,171
7/27/15,39602,19817334,67841,33753723,136818,1232,230
7/28/15,41321,19858655,69131,33822854,136901,1245,181
7/29/15,40267,19898922,66299,33889153,136979,1085,153
7/30/15,31878,19930800,50297,33939450,137044,785,108
7/31/15,39360,19970160,69897,34009347,137109,1723,177
8/1/15,36088,20006248,84287,34093634,137654,4286,234
8/2/15,32482,20038730,72633,34166267,137738,3189,204
8/3/15,39912,20078642,69232,34235499,137833,1400,230
8/4/15,41672,20120314,71146,34306645,137913,1393,168
8/5/15,42149,20162463,71111,34377756,138024,1357,160
8/6/15,43455,20205918,74669,34452425,138142,1498,170
8/7/15,41967,20247885,74844,34527269,138224,1862,154
8/8/15,39866,20287751,95931,34623200,138366,5101,205
8/9/15,33654,20321405,78144,34701344,138455,3425,177
8/10/15,40718,20362123,74754,34776575,138644,1518,228
8/11/15,25692,20387815,42534,34819109,138756,622,107
8/12/15,44145,20431960,80366,34899475,138895,1458,196
8/13/15,43174,20475134,78784,34978259,139042,1479,155
8/14/15,40903,20516037,72319,35050578,139172,1778,195
8/15/15,38777,20554814,92390,35142968,139377,4773,226
8/16/15,30337,20585151,65629,35208597,139514,2720,179
8/17/15,37446,20622597,64425,35273022,139712,1285,180
8/18/15,39913,20662510,67805,35340827,139882,1163,158
8/19/15,40721,20703231,69834,35410661,140076,1266,151
8/20/15,39275,20742506,66772,35477433,140222,1275,140
8/21/15,38033,20780539,66202,35543635,140392,1572,160
8/22/15,34269,20814808,77058,35620693,140516,3632,190
8/23/15,33059,20847867,71456,35692149,140725,2960,178
8/24/15,38676,20886543,68193,35760342,140971,1253,182
8/25/15,41052,20927595,71734,35832076,141218,1224,178
8/26/15,42373,20969968,73578,35905654,141423,1247,159
8/27/15,42801,21012769,74735,35980389,141674,1333,161
8/28/15,41418,21054187,74240,36054629,141943,1774,160
8/29/15,34053,21088240,74840,36129469,142169,3470,197
8/30/15,32581,21120821,68990,36198459,142496,2902,189
8/31/15,40043,21160864,67836,36266295,143057,1197,194
9/1/15,43069,21203933,72939,36339234,143239,1199,185
9/2/15,43004,21246937,72983,36412217,143424,1244,162
9/3/15,42462,21289399,71265,36483482,143581,1251,193
9/4/15,39572,21328971,70681,36554163,143722,1843,211
9/5/15,33669,21362640,77956,36632119,143854,4271,228
9/6/15,32875,21395515,82123,36714242,143962,4571,200
9/7/15,33280,21428795,75257,36789499,144160,3501,155
9/8/15,42344,21471139,71591,36861090,144402,1138,208
9/9/15,43528,21514667,71173,36932263,144617,1041,175
9/10/15,22023,21536690,31862,36964125,144769,416,77
9/11/15,47206,21583896,86598,37050723,144950,1929,207
9/12/15,33282,21617178,68420,37119143,145145,2620,192
9/13/15,34308,21651486,72749,37191892,145406,2814,215
9/14/15,44367,21696523,83150,37276407,145619,1751,240
9/15/15,48402,21744925,88238,37364645,145951,1533,227
9/16/15,50780,21795705,91197,37455842,146279,1424,199
9/17/15,50275,21845980,91433,37547275,146611,1508,206
9/18/15,49946,21895926,95186,37642461,146874,2090,226
9/19/15,42653,21938579,98568,37741029,1471994256,184,undefined
9/20/15,40099,21978678,90483,37831512,147602,3598,234
9/21/15,47178,22025856,85002,37916514,147960,1290,249
9/22/15,48664,22074520,84251,38000765,148254,1080,191
9/23/15,48175,22122695,88117,38088882,148522,1568,218
9/24/15,52706,22175401,96872,38185754,148809,1766,204
9/25/15,51367,22226768,95467,38281221,149055,2059,193
9/26/15,42559,22269327,93740,38374961,149309,3769,219
9/27/15,38278,22307605,82841,38457802,149566,2940,151
9/28/15,48009,22355614,90180,38547982,149886,1505,223
9/29/15,48728,22404342,87702,38635684,150277,1284,173
9/30/15,39450,22443792,65081,38700765,150811,744,77Date,Trips over the past 24-hours (midnight to 11:59pm),Cumulative trips (since launch):,Miles traveled today (midnight to 11:59 pm),Miles traveled to date:,Total Annual Members (All Time),24-Hour Passes Purchased (midnight to 11:59 pm),7-Day Passes Purchased (midnight to 11:59 pm)
10/1/15,34719,21391023,55662,38756427,150933,804,92
10/2/15,9444,21400467,12111,38768538,150976,65,4
10/3/15,16564,21417031,25241,38793779,151027,489,64
10/4/15,30214,21447245,59317,38853096,151167,2005,127
10/5/15,44581,21491826,78665,38931761,151361,1193,176
10/6/15,49720,21541546,89905,39021666,151461,1328,167
10/7/15,50141,21591687,89586,39111252,151579,1211,172
10/8/15,50179,21641866,88959,39200211,151968,1436,180
10/9/15,37283,21679149,65046,39265257,152132,1302,97
10/10/15,39348,21718497,87575,39352832,152260,3864,206
10/11/15,38967,21757464,92607,39445439,152421,4004,171
10/12/15,45584,21803048,102884,39548323,153049,2452,189
10/13/15,49047,21852095,101421,39649744,153382,1235,151
10/14/15,50000,21902095,99751,39749495,153619,1069,150
10/15/15,48783,21950878,96975,39846470,153784,1318,155
10/16/15,46486,21997364,93266,39939736,153866,1522,118
10/17/15,31811,22029175,70864,40010600,154026,2239,120
10/18/15,23978,22053153,49590,40060190,154092,1141,75
10/19/15,36570,22089723,66941,40127131,154422,661,116
10/20/15,45377,22135100,89988,40217119,154499,1093,147
10/21/15,49121,22184221,100309,40317428,154626,1339,162
10/22/15,49604,22233825,100026,40417454,154799,1342,177
10/23/15,44681,22278506,90710,40508164,154935,1429,123
10/24/15,31713,22310219,71472,40579636,155028,2254,101
10/25/15,29289,22339508,62798,40642434,155118,1761,90
10/26/15,42166,22381674,81381,40723815,155296,1039,154
10/27/15,44553,22426227,83174,40806989,155445,866,86
10/28/15,20736,22446963,34040,40841029,155572,128,25
10/29/15,45359,22492322,90367,40931396,155697,1179,167
10/30/15,44521,22536843,90284,41021680,155873,1558,154
10/31/15,31759,22568602,70082,41091762,156005,2206,145
11/1/15,30622,22599224,66939,41158701,156096,2090,111
11/2/15,44534,22643758,89099,41247800,156208,1316,190
11/3/15,49326,22693084,100760,41348560,156301,1567,166
11/4/15,49487,22742571,99144,41447704,156400,1217,139
11/5/15,43006,22785577,81276,41528980,156499,849,108
11/6/15,47162,22832739,95321,41624301,156561,1571,122
11/7/15,35586,22868325,79866,41704167,156647,2643,149
11/8/15,32318,22900643,73329,41777496,156743,2361,99
11/9/15,42262,22942905,78410,41855906,156820,899,102
11/10/15,21585,22964490,34847,41890753,156963,120,42
11/11/15,37705,23002195,68696,41959449,157038,712,95
11/12/15,37319,23039514,64556,42024005,157143,430,61
11/13/15,38970,23078484,70190,42094195,157226,892,78
11/14/15,25300,23103784,50403,42144598,157296,1349,72
11/15/15,25991,23129775,54736,42199334,157392,1497,78
11/16/15,40916,23170691,78389,42277723,157491,833,105
11/17/15,38939,23209630,68151,42345874,157570,488,66
11/18/15,41486,23251116,73030,42418904,157628,498,82
11/19/15,21890,23273006,36884,42455788,157666,167,37
11/20/15,38205,23311211,71192,42526980,157702,890,73
11/21/15,28038,23339249,56288,42583268,157731,1572,65
11/22/15,23344,23362593,44743,42628011,157781,905,39
11/23/15,30136,23392729,51812,42679823,157830,382,43
11/24/15,32218,23424947,53981,42733804,157870,392,43
11/25/15,30295,23455242,55504,42789308,157893,636,54
11/26/15,13291,23468533,35956,42825264,157907,1436,61
11/27/15,22829,23491362,51342,42876606,157929,1859,78
11/28/15,15832,23507194,32196,42908802,157952,1061,45
11/29/15,18453,23525647,36854,42945656,157997,888,45
11/30/15,30221,23555868,52674,42998330,158047,346,62
12/1/15,18399,23574267,29273,43027603,158067,61,22
12/2/15,23782,23598049,39484,43067087,158096,138,29
12/3/15,33917,23631966,59184,43126271,158130,348,42
12/4/15,34737,23666703,61717,43187988,158157,549,60
12/5/15,26355,23693058,56227,43244215,158183,1638,66
12/6/15,24942,23718000,52485,43296700,158214,1321,53
12/7/15,34139,23752139,60929,43357629,158251,554,84
12/8/15,35614,23787753,59619,43417248,158284,411,69
12/9/15,35305,23823058,59954,43477202,158317,355,33
12/10/15,39099,23862157,69925,43547127,158357,638,67
12/11/15,39059,23901216,72153,43619280,158388,822,63
12/12/15,31956,23933172,68858,43688138,158427,2192,51
12/13/15,32001,23965173,72863,43761001,158468,2470,68
12/14/15,32518,23997691,57195,43818196,158529,606,56
12/15/15,38660,24036351,67753,43885949,158572,606,54
12/16/15,35643,24071994,61011,43946960,158617,436,50
12/17/15,21960,24093954,35033,43981993,158643,120,26
12/18/15,30699,24124653,51270,44033263,158671,384,38
12/19/15,17776,24142429,30995,44064258,158692,527,31
12/20/15,17029,24159458,30624,44094882,158732,604,36
12/21/15,29800,24189258,54373,44149255,158772,494,29
12/22/15,22941,24212199,39410,44188665,158793,274,26
12/23/15,14817,24227016,28228,44216893,158825,172,19
12/24/15,18445,24245461,35231,44252124,158844,660,64
12/25/15,12331,24257792,37829,44289953,158883,2171,84
12/26/15,13912,24271704,30690,44320643,158933,1021,96
12/27/15,13176,24284880,30096,44350739,158993,1064,83
12/28/15,18889,24303769,39889,44390628,159046,756,69
12/29/15,13347,24317116,24451,44415079,159081,211,36
12/30/15,22476,24339592,43736,44458815,159148,888,57
12/31/15,20375,24359967,40032,44498847,159215,1072,54Date,Trips over the past 24-hours (midnight to 11:59pm),Cumulative trips (since launch):,Miles traveled today (midnight to 11:59 pm),Miles traveled to date:,Total Annual Members (All Time),24-Hour Passes Purchased (midnight to 11:59 pm),7-Day Passes Purchased (midnight to 11:59 pm)
1/1/16,11009,24371025,24429,44606414,159362,919,51
1/2/16,14587,24385612,29093,44635507,159403,877,34
1/3/16,15499,24401111,29616,44665123,159459,784,27
1/4/16,19593,24420704,36172,44701295,159502,166,33
1/5/16,18053,24438757,32049,44733344,159534,121,22
1/6/16,24569,24463326,40996,44774340,159564,265,27
1/7/16,27773,24491099,45986,44820326,159588,318,24
1/8/16,28709,24519808,47061,44867387,159621,364,28
1/9/16,20846,24540654,37341,44904728,159654,632,20
1/10/16,14275,24554929,25404,44930132,159682,391,18
1/11/16,22937,24577866,37393,44967525,159731,155,32
1/12/16,25211,24603077,38958,45006483,159761,151,23
1/13/16,21133,24624210,31608,45038091,159792,82,15
1/14/16,23780,24647990,37295,45075386,159813,123,29
1/15/16,28435,24676425,45993,45121379,159841,379,27
1/16/16,19178,24695603,35791,45157170,159885,803,37
1/17/16,12024,24707627,20487,45177657,159910,387,22
1/18/16,12718,24720345,19998,45197655,159931,123,13
1/19/16,17281,24737626,26966,45224621,159957,64,12
1/20/16,23419,24761045,35477,45260098,159972,126,11
1/21/16,23671,24784716,36048,45296146,159991,133,15
1/22/16,20950,24805666,31344,45327490,160004,115,6
1/23/16,0,24805666,0,45327490,160005,0,0
1/24/16,0,24805666,0,45327490,160013,0,0
1/25/16,0,24805666,0,45327490,160020,0,0
1/26/16,0,24805666,0,45327490,160028,0,0
1/27/16,6760,24812426,13698,45341188,160039,54,6
1/28/16,11944,24824370,22314,45363502,160053,81,9
1/29/16,16028,24840398,26896,45390398,160064,118,27
1/30/16,12964,24853362,23350,45413748,160084,328,23
1/31/16,16112,24869474,31280,45445028,160118,533,17
2/1/16,24334,24893808,42380,45487408,160160,202,31
2/2/16,28527,24922335,47742,45535150,160189,280,31
2/3/16,16203,24938538,24225,45559375,160216,63,12
2/4/16,27765,24966303,47458,45606833,160247,304,24
2/5/16,13669,24979972,25538,45632371,160257,102,7
2/6/16,16933,24996905,38782,45671153,160280,586,35
2/7/16,17605,25014510,31524,45702677,160316,622,30
2/8/16,19026,25033536,28648,45731325,160335,80,20
2/9/16,22740,25056276,40198,45771523,160364,156,9
2/10/16,22418,25078694,38402,45809925,160395,130,17
2/11/16,18747,25097441,27783,45837708,160425,87,15
2/12/16,16445,25113886,27143,45864851,160450,104,16
2/13/16,6625,25120511,11589,45876440,160459,46,4
2/14/16,4652,25125163,6934,45883374,160468,78,4
2/15/16,5883,25131046,8747,45892121,160480,43,1
2/16/16,14225,25145271,27802,45919923,160505,53,19
2/17/16,23572,25168843,38304,45958227,160528,182,26
2/18/16,22261,25191104,34431,45992658,160550,202,26
2/19/16,21959,25213063,35317,46027975,160568,268,17
2/20/16,24484,25237547,53540,46081515,160618,1710,50
2/21/16,20052,25257599,41645,46123160,160685,1228,29
2/22/16,28233,25285832,48237,46171397,160749,455,37
2/23/16,16133,25301965,26379,46197776,160784,62,10
2/24/16,9761,25311726,14994,46212770,160814,38,3
2/25/16,25102,25336828,42707,46255477,160849,237,23
2/26/16,22574,25359402,36101,46291578,160887,254,19
2/27/16,17226,25376628,37583,46329161,160910,706,18
2/28/16,25440,25402068,61595,46390756,160982,2335,43
2/29/16,27957,25430025,47933,46438689,161089,376,58
3/1/16,30509,25460534,55160,46493849,161146,470,66
3/2/16,26195,25486729,43535,46537384,161198,235,35
3/3/16,24061,25510790,37848,46575232,161243,215,22
3/4/16,17369,25528159,29100,46604332,161268,150,16
3/5/16,18023,25546182,36875,46641207,161310,785,46
3/6/16,18832,25565014,36377,46677584,161379,837,40
3/7/16,31492,25596506,56232,46733816,161493,633,58
3/8/16,36521,25633027,67958,46801774,161604,723,98
3/9/16,41489,25674516,81662,46883436,161732,1226,125
3/10/16,42252,25716768,82079,46965515,161867,1271,111
3/11/16,38193,25754961,76636,47042151,161987,1266,79
3/12/16,32770,25787731,81491,47123642,162086,3247,105
3/13/16,27549,25815280,63214,47186856,162214,2216,67
3/14/16,10930,25826210,16498,47203354,162289,70,17
3/15/16,31595,25857805,57722,47261076,162380,582,79
3/16/16,36067,25893872,68713,47329789,162482,930,78
3/17/16,35390,25929262,65353,47395142,162583,785,98
3/18/16,34647,25963909,69122,47464264,162670,933,87
3/19/16,24048,25987957,49113,47513377,162733,1411,69
3/20/16,16676,26004633,29737,47543114,162795,633,40
3/21/16,26414,26031047,44457,47587571,162890,428,57
3/22/16,33496,26064543,62248,47649819,163000,705,99
3/23/16,40981,26105524,80289,47730108,163136,1279,120
3/24/16,36495,26142019,67590,47797698,163216,1045,101
3/25/16,34091,26176110,70525,47868223,163320,1684,128
3/26/16,27474,26203584,67267,47935490,163407,2834,108
3/27/16,22481,26226065,52462,47987952,163501,2080,67
3/28/16,20344,26246409,35548,48023500,163589,375,60
3/29/16,31481,26277890,55067,48078567,163681,588,97
3/30/16,33674,26311564,61264,48139831,163770,769,64
3/31/16,38192,26349756,79447,48219278,163865,1141,91Date,Trips over the past 24-hours (midnight to 11:59pm),Cumulative trips (since launch):,Miles traveled today (midnight to 11:59 pm),Miles traveled to date:,Total Annual Members (All Time),24-Hour Passes Purchased (midnight to 11:59 pm),3-Day Passes Purchased (midnight to 11:59 pm),7-Day Passes Purchased (midnight to 11:59 pm)
4/1/16,34448,26384204,67595,48286873,163963,1113,0,82
4/2/16,21838,26406042,46206,48333079,164031,1193,0,63
4/3/16,15321,26421363,28615,48361694,164102,448,0,31
4/4/16,12302,26433665,20143,48381837,164167,49,0,19
4/5/16,26236,26459901,43723,48425560,164237,341,0,56
4/6/16,29364,26489265,48901,48474461,164310,443,0,37
4/7/16,30400,26519665,54591,48529052,164366,280,0,65
4/8/16,30811,26550476,53039,48582091,164425,542,0,51
4/9/16,12698,26563174,21151,48603242,164455,346,0,21
4/10/16,23228,26586402,49190,48652432,164536,1508,0,48
4/11/16,32048,26618450,59206,48711638,164632,668,0,82
4/12/16,23765,26642215,43504,48755142,164703,316,0,50
4/13/16,37538,26679753,71788,48826930,164790,761,0,106
4/14/16,38502,26718255,88278,48915208,164885,963,0,93
4/15/16,39676,26757931,86981,49002189,164996,1273,0,118
4/16/16,36148,26794079,102228,49104417,165139,3726,0,141
4/17/16,38838,26832917,115805,49220222,165354,4348,0,190
4/18/16,43989,26876906,102730,49322952,165576,1595,0,197
4/19/16,46075,26922981,107515,49430467,165812,1130,0,184
4/20/16,44542,26967523,104249,49534716,166002,1160,0,116
4/21/16,45568,27013091,104484,49639200,166153,1307,0,149
4/22/16,48806,27061897,113556,49752756,166319,4230,0,105
4/23/16,33631,27095528,96274,49849030,166462,3309,0,155
4/24/16,37862,27133390,115132,49964162,166692,4026,0,177
4/25/16,42303,27175693,100925,50065087,166902,1698,0,170
4/26/16,34639,27210332,75454,50140541,167048,741,0,97
4/27/16,41931,27252263,93272,50233813,167196,1395,0,110
4/28/16,37428,27289691,74857,50308670,167311,927,0,95
4/29/16,34878,27324569,78020,50386690,167439,1051,0,122
4/30/16,38258,27362827,110776,50497466,167638,4244,0,165
5/1/16,10697,27373524,29020,50526486,167721,260,0,24
5/2/16,38536,27412060,84418,50610904,167842,967,0,152
5/3/16,22858,27434918,57652,50668556,167987,350,0,45
5/4/16,31619,27466537,67962,50736518,168111,449,0,84
5/5/16,39903,27506440,80750,50817268,168262,970,0,107
5/6/16,18860,27525300,42069,50859337,168326,275,0,45
5/7/16,31078,27556378,78977,50938314,168427,2293,0,133
5/8/16,31197,27587575,84464,51022778,168582,2773,0,157
5/9/16,45724,27633299,103071,51125849,168779,1389,0,195
5/10/16,44849,27678148,89755,51215604,168979,876,0,133
5/11/16,51181,27729329,106139,51321743,169209,1531,0,147
5/12/16,52273,27781602,115823,51437566,169407,1971,0,169
5/13/16,32391,27813993,68317,51505883,169570,855,0,92
5/14/16,42063,27856056,108807,51614690,169769,4186,0,212
5/15/16,28662,27884718,64857,51679547,169933,1865,0,116
5/16/16,42787,27927505,94791,51774338,170102,1362,0,186
5/17/16,43396,27970901,80744,51855082,170276,1012,0,154
5/18/16,44803,28015704,93320,51948402,170465,1120,0,121
5/19/16,49184,28064888,104291,52052693,170680,1471,151,0
5/20/16,52544,28117432,118192,52170885,170960,2349,184,0
5/21/16,30524,28147956,72663,52243548,171147,2174,138,0
5/22/16,37804,28185760,98270,52341818,171349,3159,131,0
5/23/16,48578,28234338,109072,52450890,171680,1549,177,0
5/24/16,34799,28269137,68156,52519046,171898,696,98,0
5/25/16,53441,28322578,125803,52644849,172154,1702,191,0
5/26/16,52134,28374712,124751,52769600,172386,1646,195,0
5/27/16,46943,28421655,106768,52876368,172638,1988,221,0
5/28/16,34233,28455888,95897,52972265,172831,3634,296,0
5/29/16,36881,28492769,114069,53086334,173090,4820,161,0
5/30/16,32627,28525396,94241,53180575,173422,2782,134,0
5/31/16,49774,28575170,106059,53286634,174137,1492,212,0
6/1/16,54662,28629832,127143,53413777,174344,1513,156,0
6/2/16,54401,28684233,124918,53538695,174516,1649,162,0
6/3/16,38975,28723208,85292,53623987,174633,1023,118,0
6/4/16,40973,28764181,107610,53731597,174797,3824,159,0
6/5/16,22395,28786576,54320,53785917,174912,1133,57,0
6/6/16,52130,28838706,123879,53909796,175118,1861,208,0
6/7/16,51761,28890467,114761,54024557,175293,1331,127,0
6/8/16,42063,28932530,89460,54114017,175420,673,74,0
6/9/16,52885,28985415,127585,54241602,175557,1556,168,0
6/10/16,53235,29038650,119143,54360745,175697,2022,207,0
6/11/16,40980,29079630,111784,54472529,175901,3432,126,0
6/12/16,40636,29120266,117814,54590343,176087,3335,173,0
6/13/16,49069,29169335,110720,54701063,176273,1364,200,0
6/14/16,54813,29224148,116030,54817093,176467,1471,153,0
6/15/16,55049,29279197,122197,54939290,176711,1524,154,0
6/16/16,46198,29325395,100175,55039465,176865,1104,144,0
6/17/16,54236,29379631,121671,55161136,177053,2677,155,0
6/18/16,48901,29428532,143869,55305005,177210,6432,158,0
6/19/16,45270,29473802,137558,55442563,177370,5555,151,0
6/20/16,52247,29526049,119765,55562328,177660,1488,211,0
6/21/16,53564,29579613,116215,55678543,177895,1331,144,0
6/22/16,55749,29635362,119611,55798154,178168,1476,157,0
6/23/16,53206,29688568,115262,55913416,178354,1253,160,0
6/24/16,54186,29742754,123440,56036856,178545,2142,224,0
6/25/16,43000,29785754,123815,56160671,178715,4069,176,0
6/26/16,42992,29828746,117472,56278143,178893,3784,156,0
6/27/16,47023,29875769,100253,56378396,179061,1400,164,0
6/28/16,49593,29925362,99918,56478314,179215,1099,114,0
6/29/16,54882,29980244,114793,56593107,179403,1402,128,0
6/30/16,54843,30035087,125575,56718682,179625,1571,141,0Date,Trips over the past 24-hours (midnight to 11:59pm),Cumulative trips (since launch):,Miles traveled today (midnight to 11:59 pm),Miles traveled to date:,Total Annual Members (All Time),24-Hour Passes Purchased (midnight to 11:59 pm),3-Day Passes Purchased (midnight to 11:59 pm)
7/1/16,39665,30074752,82871,56801553,179756,1316,139
7/2/16,35835,30110587,111151,56912704,179903,3596,314
7/3/16,35347,30145934,111116,57023820,180016,4095,169
7/4/16,34859,30180793,109745,57133565,180158,3826,155
7/5/16,43736,30224529,92107,57225672,180338,1357,160
7/6/16,51336,30275865,109240,57334912,180540,1288,153
7/7/16,48724,30324589,99975,57434887,180725,1255,113
7/8/16,44400,30368989,91632,57526519,180852,1258,152
7/9/16,38138,30407127,107359,57633878,180990,2844,145
7/10/16,41985,30449112,123282,57757160,181172,3280,137
7/11/16,52853,30501965,122260,57879420,181381,1440,211
7/12/16,56515,30558480,120414,57999834,181571,1472,192
7/13/16,55471,30613951,121029,58120863,181748,1510,146
7/14/16,50345,30664296,108541,58229404,181877,1326,126
7/15/16,48558,30712854,104701,58334105,182016,1709,173
7/16/16,38405,30751259,103429,58437534,182144,3281,122
7/17/16,41346,30792605,120635,58558169,182314,3440,153
7/18/16,43681,30836286,97216,58655385,182488,1062,154
7/19/16,54587,30890873,116806,58772191,182624,1498,139
7/20/16,57213,30948086,128799,58900990,182792,1601,158
7/21/16,54832,31002918,128476,59029466,182950,1553,161
7/22/16,49185,31052103,105666,59135132,183072,1701,176
7/23/16,37522,31089625,101810,59236942,183177,2932,138
7/24/16,39634,31129259,113680,59350622,183332,2966,114
7/25/16,35376,31164635,85145,59435767,183473,920,150
7/26/16,52904,31217539,108783,59544550,183595,1385,168
7/27/16,54148,31271687,115744,59660294,183731,1403,132
7/28/16,50134,31321821,98694,59758988,183846,1292,123
7/29/16,37693,31359514,81355,59840343,183937,1441,162
7/30/16,27780,31387294,72197,59912540,184039,2242,112
7/31/16,27651,31414945,70377,59982917,184157,1641,82
8/1/16,49395,31464340,101134,60084051,184325,1359,166
8/2/16,56744,31521084,116187,60200238,184558,1636,181
8/3/16,56992,31578076,118370,60318608,184766,1827,143
8/4/16,56587,31634663,118563,60437171,184960,1778,148
8/5/16,53286,31687949,116534,60553705,185186,2012,185
8/6/16,44209,31732158,125188,60678893,185436,4159,153
8/7/16,43631,31775789,116183,60795076,185682,3856,149
8/8/16,52251,31828040,115847,60910923,185956,1753,184
8/9/16,56101,31884141,114892,61025815,186223,1701,165
8/10/16,50100,31934241,101761,61127576,186401,1158,109
8/11/16,47420,31981661,93639,61221215,186596,1238,152
8/12/16,44729,32026390,90685,61311900,186771,1467,144
8/13/16,38903,32065293,100035,61411935,186990,3333,125
8/14/16,32961,32098254,74055,61485990,187173,2154,91
8/15/16,49056,32147310,107305,61593295,187394,1417,175
8/16/16,50411,32197721,103010,61696305,187601,1295,164
8/17/16,53983,32251704,113583,61809888,187820,1430,138
8/18/16,53209,32304913,115041,61924929,187998,1459,163
8/19/16,51658,32356571,110723,62035652,188186,1862,175
8/20/16,45808,32402379,138864,62174516,188499,4385,167
8/21/16,35041,32437420,96941,62271457,188725,2664,127
8/22/16,54201,32491621,118995,62390452,188996,1679,192
8/23/16,58665,32550286,127012,62517464,189297,1675,170
8/24/16,58134,32608420,127066,62644530,189577,1597,160
8/25/16,53480,32661900,111985,62756515,189856,1436,169
8/26/16,52026,32713926,112005,62868520,190156,1878,197
8/27/16,45673,32759599,120578,62989098,190480,3767,173
8/28/16,44639,32804238,121056,63110154,190844,3560,159
8/29/16,53279,32857517,115101,63225255,191255,1530,174
8/30/16,57392,32914909,121098,63346353,191713,1510,160
8/31/16,57200,32972109,118815,63465168,192380,1320,136
9/1/16,38174,33010283,77415,63542583,192592,714,104
9/2/16,52999,33063282,126790,63669373,192814,2314,252
9/3/16,41629,33104911,117476,63786849,193055,4009,268
9/4/16,46020,33150931,140347,63927196,193326,5467,185
9/5/16,45431,33196362,118022,64045218,193677,3778,190
9/6/16,52432,33248794,108743,64153961,194065,1018,178
9/7/16,60278,33309072,130391,64284352,194396,1328,199
9/8/16,61551,33370623,130259,64414611,194674,1511,179
9/9/16,56804,33427427,118213,64532824,194908,1582,178
9/10/16,48454,33475881,127252,64660076,195189,3549,229
9/11/16,52238,33528119,136353,64796429,195499,3572,216
9/12/16,61083,33589202,127447,64923876,195832,1620,225
9/13/16,64818,33654020,135366,65059242,196122,1462,198
9/14/16,58928,33712948,121511,65180753,196388,1369,157
9/15/16,67312,33780260,140436,65321189,196637,1612,240
9/16/16,65257,33845517,145454,65466643,196886,2047,225
9/17/16,59199,33904716,154037,65620680,197163,5117,210
9/18/16,51685,33956401,131788,65752468,197449,3191,159
9/19/16,34205,33990606,67180,65819648,197620,555,101
9/20/16,64881,34055487,135085,65954733,197880,1454,200
9/21/16,65453,34120940,142356,66097089,198118,1566,182
9/22/16,67762,34188702,146370,66243459,198363,1681,207
9/23/16,65499,34254201,142458,66385917,198577,2053,248
9/24/16,53258,34307459,137355,66523272,198827,3990,212
9/25/16,53563,34361022,143312,66666584,199198,3871,169
9/26/16,61120,34422142,128011,66794595,199480,1375,170
9/27/16,61334,34483476,122347,66916942,199739,1175,150
9/28/16,59456,34542932,120072,67037014,199989,931,107
9/29/16,55550,34598482,104364,67141378,200201,808,131
9/30/16,21368,34619850,45194,67186572,200447,175,20Date,Trips over the past 24-hours (midnight to 11:59pm),Cumulative trips (since launch):,Miles traveled today (midnight to 11:59 pm),Miles traveled to date:,Total Annual Members (All Time),24-Hour Passes Purchased (midnight to 11:59 pm),3-Day Passes Purchased (midnight to 11:59 pm)
10/1/16,39809,"34,659,659",91771,"67,278,343",200544,2017,133
10/2/16,41018,"34,700,677",100425,"67,378,768",200664,2147,119
10/3/16,56369,"34,757,046",116682,"67,495,450",200829,1514,183
10/4/16,60196,"34,817,242",123551,"67,619,001",200954,1035,144
10/5/16,65031,"34,882,273",126942,"67,745,943",201115,1240,160
10/6/16,67580,"34,949,853",137567,"67,883,510",201234,1580,205
10/7/16,65881,"35,015,734",142612,"68,026,122",201369,2398,222
10/8/16,34624,"35,050,358",86818,"68,112,940",201485,2002,160
10/9/16,21687,"35,072,045",46334,"68,159,274",201539,713,56
10/10/16,52248,"35,124,293",107487,"68,266,761",201664,2013,163
10/11/16,58754,"35,183,047",113228,"68,379,989",201761,1172,142
10/12/16,57497,"35,240,544",119851,"68,499,840",201880,1170,153
10/13/16,61209,"35,301,753",117523,"68,617,363",201984,1064,168
10/14/16,60561,"35,362,314",123000,"68,740,363",202090,1592,183
10/15/16,51991,"35,414,305",138233,"68,878,596",202215,3904,207
10/16/16,48866,"35,463,171",126550,"69,005,146",202343,3195,172
10/17/16,62649,"35,525,820",132131,"69,137,277",202502,1447,236
10/18/16,68224,"35,594,044",143635,"69,280,912",202653,1656,194
10/19/16,69758,"35,663,802",145347,"69,426,259",202772,1902,164
10/20/16,63668,"35,727,470",131686,"69,557,945",202893,1377,198
10/21/16,40865,"35,768,335",80787,"69,638,732",202960,724,102
10/22/16,25301,"35,793,636",55557,"69,694,289",203019,658,45
10/23/16,41462,"35,835,098",99878,"69,794,167",203137,2616,134
10/24/16,55254,"35,890,352",106893,"69,901,060",203269,1145,146
10/25/16,52667,"35,943,019",96848,"69,997,908",203349,716,102
10/26/16,52466,"35,995,485",103870,"70,101,778",203410,809,85
10/27/16,21054,"36,016,539",39660,"70,141,438",203449,101,23
10/28/16,46233,"36,062,772",89857,"70,231,295",203492,766,111
10/29/16,42513,"36,105,285",103274,"70,334,569",203579,2615,153
10/30/16,37760,"36,143,045",107572,"70,442,141",203697,2971,114
10/31/16,50071,"36,193,116",107875,"70,550,016",203787,1090,123
11/1/16,55944,"36,249,060",110056,"70,660,072",203888,868,105
11/2/16,62133,"36,311,193",133258,"70,793,330",203993,1242,141
11/3/16,59632,"36,370,825",124673,"70,918,003",204108,943,174
11/4/16,57867,"36,428,692",126507,"71,044,510",204195,1538,207
11/5/16,48687,"36,477,379",128639,"71,173,149",204301,3416,177
11/6/16,39413,"36,516,792",104186,"71,277,335",204428,2293,97
11/7/16,49883,"36,566,675",106484,"71,383,819",204520,972,119
11/8/16,56589,"36,623,264",123718,"71,507,537",204616,1137,107
11/9/16,38050,"36,661,314",75883,"71,583,420",204660,257,40
11/10/16,50863,"36,712,177",111472,"71,694,892",204728,813,139
11/11/16,45826,"36,758,003",105021,"71,799,913",204802,1248,165
11/12/16,34664,"36,792,667",86968,"71,886,881",204865,1916,114
11/13/16,36806,"36,829,473",95679,"71,982,560",204958,2076,95
11/14/16,48810,"36,878,283",113590,"72,096,150",205034,728,97
11/15/16,22884,36901167,48797,72144947,205073,105,16
11/16/16,53328,"	36954495",107831,"	72252778",205170,703,113
11/17/16,53889,"	37008384",109418,"	72362196",205231,711,106
11/18/16,53370,"	37061754",109802,"	72471998",205286,1051,125
11/19/16,41208,"	37102962",98021,"	72570019",205376,2272,87
11/20/16,20616,"	37123578",45772,"	72615791",205407,350,34
11/21/16,32964,"	37156542",69754,"	72685545",205449,148,38
11/22/16,36723,"	37193265",72592,"	72758137",205479,290,35
11/23/16,34462,"	37227727",73005,"	72831142",205501,481,56
11/24/16,12122,"	37239849",42343,"	72873485",205518,641,73
11/25/16,20980,"	37260829",62444,"	72935929",205545,1011,67
11/26/16,23810,"	37284639",65654,"	73001583",205572,1356,44
11/27/16,24076,"	37308715",74381,"	73075964",205607,945,31
11/28/16,42086,"	37350801",83300,"	73159264",205667,485,42
11/29/16,14584,"	37365385",30989,"	73190253",205696,48,9
11/30/16,24434,"	37389819",52424,"	73242677",205729,117,10
12/1/16,43233,"	37433053",90239,"	73332916",205762,389,58
12/2/16,42358,"	37475411",89092,"	73422008",205794,440,52
12/3/16,29853,"	37505264",70853,"	73492861",205824,854,58
12/4/16,27454,"	37532718",71729,"	73564590",205857,930,28
12/5/16,35927,"	37568645",80214,"	73644804",205897,278,38
12/6/16,33325,"	37601970",67187,"	73711991",205939,228,26
12/7/16,38010,"	37639980",76605,"	73788596",205967,270,18
12/8/16,39621,"	37679601",72219,"	73860815",205998,235,23
12/9/16,33540,"	37713141",63950,"	73924765",206021,214,31
12/10/16,22379,37735520,52716,73977481,206033,490,20
12/11/16,17798,"	37753318",41740,"	74019221",206049,287,6
12/12/16,29035,"	37782353",58701,"	74077922",206066,175,14
12/13/16,39023,"	37821376",68858,"	74146780",206090,299,21
12/14/16,37799,"	37859175",71798,"	74218578",206130,257,16
12/15/16,25002,"	37884177",45840,"	74264418",206145,80,13
12/16/16,24484,"	37908661",48288,"	74312706",206171,139,11
12/17/16,6993,"	37915654",22363,"	74335069",206176,36,7
12/18/16,16295,"	37931949",38459,"	74373528",206200,168,14
12/19/16,25648,"	37957597",50405,"	74423933",206225,119,12
12/20/16,27677,"	37985274",50408,"	74474341",206250,202,22
12/21/16,30611,"	38015885",55746,"	74530087",206270,244,20
12/22/16,30874,"	38046759",56441,"	74586528",206293,302,18
12/23/16,26335,"	38073094",53318,"	74639846",206320,399,27
12/24/16,8014,38081108,28033,"	74667879",206334,147,10
12/25/16,9919,38091027,38209,"	74706088",206369,1052,43
12/26/16,10774,"	38101801",32446,"	74738534",206400,315,27
12/27/16,25946,"	38127747",61379,"	74799913",206450,960,68
12/28/16,23596,"	38151343",52937,"	74852850",206476,619,38
12/29/16,13202,"	38164545",29631,"	74882481",206503,104,8
12/30/16,21366,"	38185911",45743,"	74928224",206543,641,49
12/31/16,15925,"	38201836",46810,"	74975034",206585,798,33